7 12
############
#!.........#
##.####..#.#
#S....@.#..#
##...#....##
#X...#..#..#
############
