5 12
############
######..X###
#S....@..!##
######..####
############