6 15
###############
#.#...#S..#X.X#
#..#...@@.....#
#.#...#@..##..#
#!....#...#..X#
###############
