8 12
############
##X......#.#
##.#.#...#.#
#S.@...###.#
##.#.#..#..#
######..##.#
#........!.#
############
