5 12
############
#...#....#!#
#S.....#.@.#
##X........#
############
