11 13
############
#XX..#.##S##
#XX..###.!.#
#XX.....@@.#
#XX..#.#.@.#
#XX###.#.@.#
####.@.#@..#
####..@#.@.#
####.@..@..#
####!!##..!#
############