6 12
############
#X.......#.#
##.#.#.#.#.#
#S....@...##
##.#.#..#.!#
############
